 ##################### 
 #   ##  #   #   #   # 
 #                 @ ##
##### #  #   ### ## ###
#   # ## ######   #   #
#     #       #   #   #
## #  #       #####   #
## #########  #   # ###
#          #  #     #  
# ## ### ###  ## #  ###
# #   #   ##  ## ###  #
#             #       #
# #   #   ##  #   ##  #
##### ############## ##
#          #   #      #
#    #         # #    #
# # ##  #  ## ##    # #
#       ####      # # #
#         .#   #      #
#######################
