###############
#   #     #   #
#   #  .  #   #
#   #     #   #
#   #######   #
#     ###     #
#             #
#             #
#      @      #
#             #
###############