#########
#       ###
# .       #
## $      #
####$    ##
#  $     ##
# @       #
###. .    #
  ########