###############
#             #
#      .      #
#             #
#    #####    #
#    #   #    #
#    #   #    #
#    #   #    #
#             #
#      @      #
#             #
###############