########################
#          #.          #
#####      #           #
#@  #      #           #
#   #      #           #
#   #      #           #
#   #      #           #
#   #      #           #
#   #      ##########  #
#                      #
#                      #
#                      #
########################
