#########################
#           #           #
#           #           #
#           #           #
#           #           #
#           #      .    #
#                       #
#           #           #
#           #           #
#           #           #
#           #           #
#           #           #
###### ########### ######
#           #           #
#           #           #
#           #           #
#           #           #
#           #           #
#                       #
#    @      #           #
#           #           #
#           #           #
#           #           #
#           #           #
#########################
