#########################
#           #           #
#           #           #
#           #           #
#           #           #
#    @      #           #
#                       #
#           #           #
#           #           #
#           #           #
#           #           #
#           #           #
###### ########### ######
#           #           #
#           #           #
#           #           #
#           #           #
#           #           #
#                       #
#           #      .    #
#           #           #
#           #           #
#           #           #
#           #           #
#########################
