########################
#.       #             #
#        #         #   #
#                  #   #
#        #         #   #
#        #         #   #
####################   #
#        #         #   #
#        #         #   #
#                  #   #
#        #         #   #
#@       #             #
########################
