########################
#      #       #     . #
#              #       #
#      #       #       #
#      #               #
#      #       #       #
#      #       #       #
## ######## ############
#      #       #       #
#      #       #       #
#      #       #       #
#      #       #       #
#      #               #
#      #       #       #
#### ################ ##
#      #       #       #
#      #       #       #
#      #               #
#      #       #       #
#              #       #
#@     #       #       #
########################
