###########
#         #
# .       #
#         #
#         #
#         #
#         #
#         #
#      @  #
#         #
###########