#######
#     #
# @   #
#     #
#   . #
#######